aay: thz crg nse
pal: clf cdk hib
yet: rtq kuq xsh
xit: boy
ybx: dtl mkd
ctl: tje xzd agr
mkq: ooe haq ggr
qpm: psu
zse: wqp
gmb: aay
crg: uur yxs beg hrm bww
vjy: jus abh
qip: qpm rxu jny
gdf: yrn igi mjr acq
xcp: bui fft hmn
sgn: kun adr
wtc: gyt qyv jjp
brp: jgp
clf: ket sfo
wyd: hri sqn
fnb: thz
oec: acq yrn
pcn: uws
dgt: yji egt hxx
lrh: pqa vqs
aod: yji xfa
oae: jsz xjo
cpr: you ywc mkd fpm dtl
hfj: bxm
qjn: abh
wuq: nae ybo
nsy: ezh kwb lrb
ouz: igi acq
zzp: hib
oos: nzd gkv
nae: mjr
hxx: cbe xdp fve
mch: hxx egt xfa sfp
iho: out
psb: zjz ftk
tjr: mkd dtl fpm
zmi: qzh qrw jjm
sjd: dhb rbh tjg
bth: fpm dtl you ywc mkd
kvd: ugu sqn dre
idw: uzm phj
mzn: nse crg thz
tff: uzl ypi wuq
ngy: rha gan
dnr: kcl ruz ddk
hmg: clk owj qik
hwh: out
vdw: xrq usz djd ina hqm
xxt: phq
ltu: csn ylc qmt upd
upm: boy nnn kfe
uoe: ktf upr brp
kjz: srr
xgg: boy kfe gmk nnn
kwr: fnb zbn
nqo: jsz xjo npv aij
kfr: xpp nzd
xdw: foo zdy
gup: znc psb
kcl: tuf gqo
vkw: bgu
wae: out
ftk: poq duj vdw
wsq: xou
hmn: epq yeh cml
xie: yrj bwt whq
hrm: xdw lhb
puy: thz crg
wwq: erj xxt zdn qmo zmx
qxl: kad gan hnp rha lcj
ncn: zle
vxr: jsz aij npv xjo
ssx: vse nqb uih jvd
yjd: out
ecd: bpx
uzl: nae ybo zmr
kuq: fei ums zse
tni: nor nay skd
dhb: kvd wyd jra yju
mte: nse crg thz
mki: vmy yvh
nay: hpy jbj
oqx: arr vrg wae grx
nal: las ond tjr jdw
xcv: qlg dnr igk oma yiy dft gih nwo lrh vyz irh lsq xfz ojm yhw tff fye
exj: rgw uqa ggn
zle: fle rxd qsi
xoq: yvh
czf: bxm gdf
vck: yvh
nzx: jjm jbj qzh hpy
vqs: ooy tdg
lcj: ubk mzn mni gct
dre: xzj vbs
ooq: npv jsz
jus: rkh ndx
des: nsy
hhq: ond
unp: vgu
ttk: out
mym: vqs pcn
qeu: hpy
rvq: pzn
omi: otj
ves: ujn
wlk: out
qsb: jny
vac: uzl ypi wuq
lln: jbj qrw jjm
opu: mpf rvq pmu xqj tjw
cxp: awr eun
rgg: gkv nzd xpp
gyt: nor skd
qmo: idw
ech: brt txx
rxd: qrw jbj hpy
qub: urb
ojm: ngl afm
haq: aas ygo sgn roe
anf: xxt zdn zmx qmo
clb: boy gmk kfe
lot: qik owj
xqe: zve
oma: tyc ngl afm
nwo: tyc
xzd: clb nex
icd: uoc pcc kuh
clk: mky lum bzq gtp
kfe: vxr ume nxo rqe soj pqn anf kot hzq xor iig ves edu
dyv: wsq bay vfa
arg: uoe otq
sqn: vbs
het: bui fft
tli: hwh qlh jyp iho
uih: zvs dpi
htb: rgw ggn uqa
ylc: rvi
yji: xdp
tzh: zyx
kva: kad gan hnp lcj
rxu: prd zyx psu
pmu: wow fxr wvz
owj: bzq gtp lum mky
uov: ktf upr mgl brp
ndy: aay frr vbh hjn
you: ulg emg aja qub zzp zsh gup qip hen
upr: zga
hij: jyp hwh
ooy: idb kwi
xvr: tzh jny qpm
kji: ree wqp tal dmg
tjw: pzn
ltb: gih oma dnr qlg cqw tff ucf ojm xfz lsq ypb eyl lrh vyz nwo eep vac
thz: ctl rzu arg mkq hrm son yxs uij ezt jbm bww swc
cpo: aay frr hjn
tuf: bxm naj
sgu: wuq uzl
log: crg thz nse
prf: fnb
zdn: phq emt xow idw xdb
jjg: vcl neq
ypi: qpy zmr nae
tqu: yrn
fpm: flf txg lot hqu qip zzp rlu hmg ulg qsb num xye xqe jry hen qub zsh
dux: hri sqn ugu vjf
hri: lss vbs xzj
boy: iig mxt xor llw edu nqo xde ume kot dai bhw ves xcy mac oae wwq soj hwt pqn ooq rqe nxo vxr hzq anf
ytr: nex xgg clb
ndd: jjm jbj hpy qzh
tal: wlk
nex: boy
bpx: yrn mjr
dxj: kfr bie
ong: out
wwv: kfr oos rgg
urb: whq yrj bwt
tua: kfe gmk boy
uqa: jjm qzh hpy
wkl: yrj whq
zjp: igi yrn acq
ina: jgq knw sgh
dwe: kfe nnn boy
njt: ahv jjg
dmg: jfx xrh
jjm: omi bjg vtr pxo spi yxr bsm wig jya mki uwp ltu sjd opu unp jzf vck iyf uxg xoq rtr
txg: hib clf
ddz: cyz
dtp: crg
vcl: out
jzf: mru otj
cdk: sfo ucw
ofb: yrn
ubk: thz
wqp: wfz
utq: hpy qzh jbj jjm
xdp: mdt
kuh: gmb myc cpo ndy
xqj: wow wvz
sxx: svn bsd
foo: gus yud
ree: wfz xrh wlk jfx
kah: oqx hvd
xpp: thz crg
biz: fft bui hmn
bzq: rac njt
qzh: vtr pxo omi bjg spi yxr bsm wig jya ltu uwp mki sjd jzf unp iyf vck uxg xoq
yrj: vjy qjn xnv
ugu: xzj lss
neq: out
knw: out
jfx: out
pqa: ooy uws tdg
mni: nse thz
nki: poq uvm dhs
bjg: pmu rvq tjw xqj
djd: sgh mjk knw
xhq: foo zdy
tyc: pgu ech
krk: yji egt sfp
rob: odr jus
ndx: out
rlu: clk owj
skd: qzh jjm
mfj: qrw hpy
abh: vew ong
aij: wtc
bxm: acq igi yrn
zyx: quv ypg kah
jra: dre
xor: lqh exj
agr: nex clb
zvs: zmi qeu
kwb: qrw jbj
hpy: omi sjd pxo iyf
ulg: xie
adn: uyp svn ofb hpc bsd
idb: acq mjr igi yrn
uur: lhb xdw
wfz: out
fle: hpy qzh
mjr: biz kva jhw fhk het eeh yhq dxj rki lno icd wam mzw dyv uwg tul kks tml
ruz: czf hfj tuf
xgn: twj ouz bpx
hqu: jgn
jvd: iql zvs
kiy: iic xou
lvk: rxd lln
czp: ake aoz jum
rkh: out
xye: urb kqf wkl
phj: jbj hpy
wow: byh nal ejs nqs
jyp: out
phq: uzm hjy phj
azq: out
vmy: ady cpr gpc
xrh: out
mru: qer
qsi: hpy
dpi: utq ndd nzx
znc: ftk
twj: mjr igi yrn
jyi: thz
jhw: pcc kuh
yju: sqn hri dre vjf
jgp: kfe gmk
yxr: qmt ylc csn
mlh: tzp
igk: xgn ecd wvc
zbn: nse crg thz
tul: uoc pcc
rvi: fpm you
zsh: xie kqf
cdl: chc zle lvk
nse: beg bww nzs mkq son ctl uij ezt rzu
frr: crg
qqm: srr nsy ygm
mxt: pee qqm kjz mnz
edu: ssx ujn wbx wly
swi: vew ong qcq
uwg: vbx aoz
vbs: mkd ywc
kot: teb ncn cdl lzl
kad: mzn mni gct ubk
zmx: emt idw xdb xow phq
ezh: hpy jbj
aas: xit adr tua
jsz: awt
zjz: uvm poq duj
bui: fme yeh jyi
xew: kad
rla: pqj hij tzp tli
gct: nse
psu: ypg kah
usz: knw mjk jgq
fye: sxx pmg
ywc: bfu zsh xqe xye jry xvr zzp rlu pal qip lot hqu emg flf aja
awt: jjp qyv tni wbu gyt
lqh: rgw ggn mfj
xxp: boy nnn kfe gmk
flf: clf cdk hib
grc: wae grx pia vrg
yud: yov
vbm: nwo qlg sgu igk eyl vkw ucf
ypg: oqx hvd grc
byh: ond las
fei: tal wqp dmg ree
npv: wtc ldi xss awt
wvc: bpx twj
soj: cdl
bay: evl
qer: dtl fpm you mkd
fxr: nal ejs nqs
lum: mpk
xzj: you mkd dtl
xjo: ldi awt xss
dai: kjz qqm mnz des
bie: gkv
dtl: hqu lot txg gup xvr zzp emg jry hen xye xqe zsh hmg ulg num
nqs: tjr ond jdw las
ggn: hpy jbj
llw: zmx
ket: qqu mlh rla
jbm: uoe otq uov
brt: tqu zjp qxi szy
xij: zjp szy qxi
ggr: roe sgn aas
xde: aij jsz
yxs: ytr xzd agr oom
wvz: nqs ejs nal byh
jum: kwr prf
vbx: kwr prf nwj
qlh: out
hzq: lqh
xdb: hjy gwo uzm
hjy: qzh
rqe: ncn teb
ngl: qfq pgu
tnm: oos
qpy: igi
hvd: wae
izt: out
fve: mdt awr eun
nwj: fnb dtp
skf: ftk zjz
qrw: jya ltu uwp mki vtr pxo omi bjg spi yxr bsm uxg rtr xoq opu sjd unp iyf vck
jdw: fpm dtl you mkd
idd: xcd
wxj: qrw jjm qzh hpy
wam: wsq
ahv: yjd izt azq
zmr: yrn acq
rgw: jjm jbj qrw qzh hpy
xrq: mjk
bgu: tdg uws ooy
yrn: eeh yhq lno dxj rki biz kva fhk het wam ngy xew wwv icd uwg tul kks tml tnm czp mzw xcp qxl
dsf: dnr cqw ddz vkw yiy ypb yhw ucf
mxc: nnn boy
uoc: ndy myc gmb
ooe: roe sgn ygo
srr: cmf lrb kwb
ygm: cmf wxj ezh
cml: crg thz
mkd: aja emg flf qip lot pal txg rlu gup zzp xvr hmg ulg num qsb hen xqe xye fpu zsh bfu qub
pzn: hhq ejs nal byh
mpf: wow fxr wvz
qfq: xij
cmf: qzh jjm
arr: out
nzs: mch dgt ycm aod
pcc: myc
lss: fpm dtl mkd you
mac: des
mjk: out
yhw: ngl znt tyc
acq: tml czp tnm mzw xcp biz kva ngy wwv icd uwg tul kks dyv qxl lno jhw pat fhk het wam xew
sgh: out
aoz: prf nwj
ybo: mjr acq yrn igi
erj: xdb idw
mrd: owc ybx rvi
odr: rkh
xcy: kjz mnz
vbh: thz nse
epq: nse thz
whq: qjn vjy
nzd: thz nse
grx: out
ryx: gmk kfe boy
dac: ady cpr gpc
oom: xgg nex
ake: nwj kwr
pat: rha hnp lcj
yhq: bay kiy
rki: kuh
xnv: jus abh
rzu: lhb xhq xdw
gtp: kxk
mgl: zga ryx jgp mxc
qxi: mjr acq igi
szy: mjr igi yrn
qik: lum gtp bzq mky
wig: mrd qmt ylc
quv: oqx grc
kun: kfe gmk
pxo: vmy dac
qlg: ypi wuq
xcd: boy nnn gmk
ucw: mlh rla
bww: aod dgt mch
otq: mgl
lno: uoc
gwo: jjm qrw hpy
roe: xit tua adr kun
dft: cyz sxx pmg
mky: mpk njt rac
jpb: ddz nwo ojm tff fye lrh eyl lsq xfz sgu oma dft gih vkw vac eep yhw ucf vyz irh mym ypb igk cqw qlg yiy
sfp: fve cxp
cbe: mdt
ypb: adn
bge: pee
jry: jgn zve
gqo: gdf bxm naj
las: ywc you
afm: ech pgu
czw: xcd upm dwe yov
evl: mte log kkt
qmt: ybx
jjp: skd nor
swc: uoe otq uov
ygo: xit xxp
ibb: nqb jvd uih vse
uyp: mjr
iig: wbx ibb ssx
iic: log mte kkt
chc: lln qsi
myc: aay vbh hjn
xow: hjy phj
vfa: evl xou iic
gmk: hzq anf dai kot rqe soj hwt wwq bge vxr ume nxo xde nqo oae edu mac iig ves bhw llw xor mxt
yov: gmk nnn boy
iyf: dac yvh vmy
tdg: dol kwi idb
uxg: vgu
pia: out
lsq: ruz kap
emg: skf xlj psb
ktf: ryx
uzm: jbj jjm qzh
ezt: tje ytr xzd agr
gkv: thz crg nse
eyl: bgu pqa
upd: rvi bth ybx owc
fpu: jny rxu qpm
gpc: dtl you ywc mkd
jgq: out
ujn: uih jvd nqb wwa vse
owc: mkd you ywc
ith: gdf
gih: xgn ecd wvc
vgu: rcw rju
irh: ruz kcl
igi: qxl mzw czp xcp dyv kks tml wwv icd ngy kva biz het fhk dxj yhq
cqw: adn sxx cyz
yiy: znt
xlj: zjz nki
pmg: bsd hpc uyp
eep: uzl wuq
teb: chc
rbh: jra wyd kvd yju dux
ond: ywc fpm
duj: djd ina hqm
tzp: qlh hwh
ycm: egt hxx xfa yji sfp
vtr: rbh tjg
jya: rvq
ilz: idd czw yud
ejs: tjr ond jdw
jgn: rtq
eeh: kfr rgg oos
kxk: ahv rbo
nnn: nqo edu rqe ves bge bhw hwt xor xcy
xss: tni qyv wbu gyt
lzl: lvk
txx: qxi szy tqu zjp
egt: cbe xdp
kqf: whq
kap: gqo ith czf tuf hfj
xou: log
rtq: zse kji ums fei
mzw: bui hmn
bhw: htb
fhk: vfa kiy wsq
vse: txm dpi iql
sfo: qqu
nqb: txm zvs
ume: lqh
svr: jpb dsf xcv ltb vbm
num: cdk clf
vrg: out
bsd: igi yrn acq
znt: pgu ech qfq
csn: owc
qqu: pqj tzp tli
son: haq ooe
cyz: uyp hpc ofb bsd
nxo: exj
rha: puy mni
vew: out
bfu: yet jgn zve
qyv: skd
aja: xlj
bsm: mru otj vgu
uwp: rbh tjg
vyz: pcn bgu pqa
mpk: jjg rbo
zve: kuq xsh
ldi: tni qyv jjp gyt
bwt: xnv kjr rob
xfz: ecd
eun: boy gmk
tml: jum ake
awr: kfe gmk nnn
pqj: jyp iho ttk
lhb: ilz foo zdy
hpc: yrn igi mjr acq
ady: mkd you ywc fpm
fme: thz
pgu: txx
fft: epq cml jyi
hen: wkl kqf xie
xfa: xdp
uvm: xrq djd hqm
kjr: abh swi
rju: ywc you dtl
tjg: wyd kvd
zga: kfe
hqm: jgq sgh
txm: utq zmi nzx qeu
hwt: ssx wly
xsh: zse fei
ums: dmg
nor: hpy qrw jbj jjm
yvh: ady
hjn: nse
hnp: mni
qcq: out
emt: uzm hjy
tje: nex xgg
yeh: nse thz crg
wbu: nay
iql: zmi ndd
svn: acq mjr igi yrn
kkt: thz nse
kks: kiy bay
ucf: ecd
rac: jjg
lrb: jjm jbj qzh
vjf: xzj
uws: oec idb
gan: gct mzn ubk
zdy: idd
dhs: xrq djd
naj: acq
adr: boy nnn gmk
mdt: gmk boy
otj: qer rju
rbo: yjd vcl izt azq
mnz: nsy
poq: hqm ina usz
dol: yrn mjr
pqn: erj xxt
uij: krk mch ycm dgt
kwi: yrn acq
wbx: nqb
prd: quv
hib: sfo ucw ket
wly: wwa
beg: ooe
wwa: zvs
rcw: mkd ywc
pee: ygm
rtr: mrd ylc csn
jbj: uwp mki ltu jya wig bsm yxr spi bjg pxo vtr xoq rtr vck unp jzf opu sjd
spi: ylc
jny: prd
gus: dwe xcd upm yov
ddk: ith gqo hfj tuf
